11111111111111111111111111111111111111111111111111111111111111111111111111111111111111111111111111111111
1P010000000C110010000000C110010000000C110010000000C110010000000C110010000000C110010000000C110010000000C1
10000111110011000011111001100001111100110000111110011000011111001100001111100110000111110011000011111001
100011E000001100011E000001100011E000001100011E000001100011E000001100011E000001100011E000001100011E000001
11111111111111111111111111111111111111111111111111111111111111111111111111111111111111111111111111111111
11111111111111111111111111111111111111111111111111111111111111111111111111111111111111111111111111111111
10010000000C110010000000C110010000000C110010000000C110010000000C110010000000C110010000000C110010000000C1
10000111110011000011111001100001111100110000111110011000011111001100001111100110000111110011000011111001
100011E000001100011E000001100011E000001100011E000001100011E000001100011E000001100011E000001100011E000001
11111111111111111111111111111111111111111111111111111111111111111111111111111111111111111111111111111111
11111111111111111111111111111111111111111111111111111111111111111111111111111111111111111111111111111111
10010000000C110010000000C110010000000C110010000000C110010000000C110010000000C110010000000C110010000000C1
10000111110011000011111001100001111100110000111110011000011111001100001111100110000111110011000011111001
100011E000001100011E000001100011E000001100011E000001100011E000001100011E000001100011E000001100011E000001
11111111111111111111111111111111111111111111111111111111111111111111111111111111111111111111111111111111
11111111111111111111111111111111111111111111111111111111111111111111111111111111111111111111111111111111
10010000000C110010000000C110010000000C110010000000C110010000000C110010000000C110010000000C110010000000C1
10000111110011000011111001100001111100110000111110011000011111001100001111100110000111110011000011111001
100011E000001100011E000001100011E000001100011E000001100011E000001100011E000001100011E000001100011E000001
11111111111111111111111111111111111111111111111111111111111111111111111111111111111111111111111111111111
11111111111111111111111111111111111111111111111111111111111111111111111111111111111111111111111111111111
10010000000C110010000000C110010000000C110010000000C110010000000C110010000000C110010000000C110010000000C1
10000111110011000011111001100001111100110000111110011000011111001100001111100110000111110011000011111001
100011E000001100011E000001100011E000001100011E000001100011E000001100011E000001100011E000001100011E000001
11111111111111111111111111111111111111111111111111111111111111111111111111111111111111111111111111111111
11111111111111111111111111111111111111111111111111111111111111111111111111111111111111111111111111111111
10010000000C110010000000C110010000000C110010000000C110010000000C110010000000C110010000000C110010000000C1
10000111110011000011111001100001111100110000111110011000011111001100001111100110000111110011000011111001
100011E000001100011E000001100011E000001100011E000001100011E000001100011E000001100011E000001100011E000001
11111111111111111111111111111111111111111111111111111111111111111111111111111111111111111111111111111111
11111111111111111111111111111111111111111111111111111111111111111111111111111111111111111111111111111111
10010000000C110010000000C110010000000C110010000000C110010000000C110010000000C110010000000C110010000000C1
10000111110011000011111001100001111100110000111110011000011111001100001111100110000111110011000011111001
100011E000001100011E000001100011E000001100011E000001100011E000001100011E000001100011E000001100011E000001
11111111111111111111111111111111111111111111111111111111111111111111111111111111111111111111111111111111
11111111111111111111111111111111111111111111111111111111111111111111111111111111111111111111111111111111
10010000000C110010000000C110010000000C110010000000C110010000000C110010000000C110010000000C110010000000C1
10000111110011000011111001100001111100110000111110011000011111001100001111100110000111110011000011111001
100011E000001100011E000001100011E000001100011E000001100011E000001100011E000001100011E000001100011E000001
11111111111111111111111111111111111111111111111111111111111111111111111111111111111111111111111111111111
11111111111111111111111111111111111111111111111111111111111111111111111111111111111111111111111111111111
10010000000C110010000000C110010000000C110010000000C110010000000C110010000000C110010000000C110010000000C1
10000111110011000011111001100001111100110000111110011000011111001100001111100110000111110011000011111001
100011E000001100011E000001100011E000001100011E000001100011E000001100011E000001100011E000001100011E000001
11111111111111111111111111111111111111111111111111111111111111111111111111111111111111111111111111111111
11111111111111111111111111111111111111111111111111111111111111111111111111111111111111111111111111111111
10010000000C110010000000C110010000000C110010000000C110010000000C110010000000C110010000000C110010000000C1
10000111110011000011111001100001111100110000111110011000011111001100001111100110000111110011000011111001
100011E000001100011E000001100011E000001100011E000001100011E000001100011E000001100011E000001100011E000001
11111111111111111111111111111111111111111111111111111111111111111111111111111111111111111111111111111111
11111111111111111111111111111111111111111111111111111111111111111111111111111111111111111111111111111111
10010000000C110010000000C110010000000C110010000000C110010000000C110010000000C110010000000C110010000000C1
10000111110011000011111001100001111100110000111110011000011111001100001111100110000111110011000011111001
100011E000001100011E000001100011E000001100011E000001100011E000001100011E000001100011E000001100011E000001
11111111111111111111111111111111111111111111111111111111111111111111111111111111111111111111111111111111
11111111111111111111111111111111111111111111111111111111111111111111111111111111111111111111111111111111
10010000000C110010000000C110010000000C110010000000C110010000000C110010000000C110010000000C110010000000C1
10000111110011000011111001100001111100110000111110011000011111001100001111100110000111110011000011111001
100011E000001100011E000001100011E000001100011E000001100011E000001100011E000001100011E000001100011E000001
11111111111111111111111111111111111111111111111111111111111111111111111111111111111111111111111111111111
11111111111111111111111111111111111111111111111111111111111111111111111111111111111111111111111111111111
10010000000C110010000000C110010000000C110010000000C110010000000C110010000000C110010000000C110010000000C1
10000111110011000011111001100001111100110000111110011000011111001100001111100110000111110011000011111001
100011E000001100011E000001100011E000001100011E000001100011E000001100011E000001100011E000001100011E000001
11111111111111111111111111111111111111111111111111111111111111111111111111111111111111111111111111111111
11111111111111111111111111111111111111111111111111111111111111111111111111111111111111111111111111111111
10010000000C110010000000C110010000000C110010000000C110010000000C110010000000C110010000000C110010000000C1
10000111110011000011111001100001111100110000111110011000011111001100001111100110000111110011000011111001
100011E000001100011E000001100011E000001100011E000001100011E000001100011E000001100011E000001100011E000001
11111111111111111111111111111111111111111111111111111111111111111111111111111111111111111111111111111111
11111111111111111111111111111111111111111111111111111111111111111111111111111111111111111111111111111111
10010000000C110010000000C110010000000C110010000000C110010000000C110010000000C110010000000C110010000000C1
10000111110011000011111001100001111100110000111110011000011111001100001111100110000111110011000011111001
100011E000001100011E000001100011E000001100011E000001100011E000001100011E000001100011E000001100011E000001
11111111111111111111111111111111111111111111111111111111111111111111111111111111111111111111111111111111
11111111111111111111111111111111111111111111111111111111111111111111111111111111111111111111111111111111
10010000000C110010000000C110010000000C110010000000C110010000000C110010000000C110010000000C110010000000C1
10000111110011000011111001100001111100110000111110011000011111001100001111100110000111110011000011111001
100011E000001100011E000001100011E000001100011E000001100011E000001100011E000001100011E000001100011E000001
11111111111111111111111111111111111111111111111111111111111111111111111111111111111111111111111111111111
11111111111111111111111111111111111111111111111111111111111111111111111111111111111111111111111111111111
10010000000C110010000000C110010000000C110010000000C110010000000C110010000000C110010000000C110010000000C1
10000111110011000011111001100001111100110000111110011000011111001100001111100110000111110011000011111001
100011E000001100011E000001100011E000001100011E000001100011E000001100011E000001100011E000001100011E000001
11111111111111111111111111111111111111111111111111111111111111111111111111111111111111111111111111111111
11111111111111111111111111111111111111111111111111111111111111111111111111111111111111111111111111111111
10010000000C110010000000C110010000000C110010000000C110010000000C110010000000C110010000000C110010000000C1
10000111110011000011111001100001111100110000111110011000011111001100001111100110000111110011000011111001
100011E000001100011E000001100011E000001100011E000001100011E000001100011E000001100011E000001100011E000001
11111111111111111111111111111111111111111111111111111111111111111111111111111111111111111111111111111111
11111111111111111111111111111111111111111111111111111111111111111111111111111111111111111111111111111111
10010000000C110010000000C110010000000C110010000000C110010000000C110010000000C110010000000C110010000000C1
10000111110011000011111001100001111100110000111110011000011111001100001111100110000111110011000011111001
100011E000001100011E000001100011E000001100011E000001100011E000001100011E000001100011E000001100011E000001
11111111111111111111111111111111111111111111111111111111111111111111111111111111111111111111111111111111
11111111111111111111111111111111111111111111111111111111111111111111111111111111111111111111111111111111
10010000000C110010000000C110010000000C110010000000C110010000000C110010000000C110010000000C110010000000C1
10000111110011000011111001100001111100110000111110011000011111001100001111100110000111110011000011111001
100011E000001100011E000001100011E000001100011E000001100011E000001100011E000001100011E000001100011E000001
11111111111111111111111111111111111111111111111111111111111111111111111111111111111111111111111111111111
