111111111111111
1ECCCCCCCCCCCC1
1111111111111C1
1CCCCCCCCCCCCC1
1C1111111111111
1CCCCCCCCCCCCP1
111111111111111
