111111111111
11111M110011
1P00000000E1
10001011M011
11C011111111
111111111111
