11111
1PME1
10101
1M0C1
11111
