1111111111111
10110000000C1
1100011111001
1P0011E0000M1
1111111111111
