1111111111111
1M110000M00C1
1100011111001
1P0011E0000M1
1111111111111
