1111111111111
1M11000000MC1
1100011111001
1P0011E000M01
1111111111111
