1111111111111
1001000000MC1
1000011111001
1P0011E000M01
1111111111111
