1111111111111
10010000000C1
1PQ0011111001
1QP011E000001
1111111111111
