1111111111111
10010000000C1
1Pp0011111001
1pP011E000001
1111111111111
