11111111
1PC00001
10E000M1
11111111
