1111111111111
1M110000M00C1
11000111110C1
1P0011E0000M1
1111111111111
